{
    "maze": [
        ["#", "#", "#", "#", "#", "#", "#"],
        ["#", "S", " ", "G", " ", "T", "#"],
        ["#", "#", "#", " ", "#", "#", "#"],
        ["#", "P", " ", "B", " ", "L", "#"],
        ["#", "#", "#", " ", "#", "#", "#"],
        ["#", "H", " ", "G", " ", "E", "#"],
        ["#", "#", "#", "#", "#", "#", "#"]
    ]
}