{
    "maze": [
        ["#", "#", "#", "#", "#", "#", "#", "#", "#", "#", "#", "#", "#", "#", "#"],
        ["#", "S", "#", " ", "#", " ", "#", " ", "#", " ", " ", " ", " ", " ", "#"],
        ["#", " ", "#", " ", "#", " ", "#", " ", "#", "#", "#", " ", "#", "#", "#"],
        ["#", " ", "#", " ", " ", " ", "#", " ", "#", " ", " ", " ", "#", " ", "#"],
        ["#", " ", "#", " ", "#", "#", "#", " ", "#", " ", "#", "#", "#", " ", "#"],
        ["#", " ", " ", " ", "#", " ", " ", " ", " ", " ", " ", " ", "#", " ", "#"],
        ["#", "#", "#", " ", "#", " ", "#", "#", "#", " ", "#", "#", "#", " ", "#"],
        ["#", " ", " ", "T", "G", " ", " ", " ", "#", " ", "L", " ", " ", " ", "#"],
        ["#", " ", "#", "#", "#", "#", "#", "#", "#", " ", "#", " ", "#", " ", "#"],
        ["#", " ", " ", " ", "#", " ", "#", " ", "#", " ", "#", " ", "#", " ", "#"],
        ["#", "#", "#", "#", "#", " ", "#", " ", "#", "#", "#", "#", "#", " ", "#"],
        ["#", " ", " ", "G", " ", "G", " ", " ", "#", " ", " ", " ", " ", " ", "#"],
        ["#", " ", "#", "#", "#", " ", "#", " ", "#", "#", "#", " ", "#", "#", "#"],
        ["#", "G", " ", " ", "#", " ", "#", " ", " ", "G", " ", "B", " ", "E", "#"],
        ["#", "#", "#", "#", "#", "#", "#", "#", "#", "#", "#", "#", "#", "#", "#"]
    ]
}